1111111111111111111111111111111111
1SSSSSSSSSSSSSSSSSSSSECPSSSSSSSSS1
1SSSSSSSSSSSSSSSSSSSS111SSSSSSSSS1
1111111111111101111111111111111111